##########
#S#      #
# #  #  ##
# # #  # #
#   #    #
####     #
#   #    #
# #  #   #
#E#      #
##########
